2 2 2 2 2 2 2 2 2 2 2 2 2 2 2 2 2 2 2 2 2 2 2 2 2 2 2 2 2 2 2 2 2 2 2 2 2 2 2 2 2 2 2 4 4 4 4 4 4 4 4 4 1 4 4 4 4 1 4 4 4 4 4 4 4 13 13 13 2 2 2 2 2 2 2 2 2 2 2 2 2 2 2 2 2 2 2 2 2 2 2 2 2 2 2 2 2 13 13 13
2 2 2 2 2 2 2 2 2 2 2 2 2 2 2 2 2 2 2 2 2 2 2 2 2 2 2 2 2 2 2 2 2 2 2 2 2 2 2 2 2 2 2 2 2 2 2 2 2 4 4 4 1 2 2 2 2 1 2 2 2 2 2 2 2 2 2 13 2 2 2 2 2 2 2 2 2 2 2 2 2 2 2 2 2 2 2 2 2 2 2 2 2 2 2 2 2 2 13 13
2 2 2 2 2 2 2 2 2 2 2 2 2 2 2 2 2 2 2 2 2 2 2 2 2 2 2 2 2 2 2 2 2 2 2 2 2 2 2 2 2 2 2 13 13 13 13 13 13 2 2 2 1 4 4 4 4 1 13 13 13 2 2 2 2 2 13 2 13 2 2 2 2 2 2 2 2 2 2 2 2 2 2 2 2 2 2 2 2 2 2 2 2 2 2 2 2 2 2 2
2 2 2 2 2 2 2 2 2 2 2 2 2 2 2 2 2 2 2 2 2 2 2 2 2 2 2 2 2 2 2 2 2 2 2 2 2 2 2 2 2 2 2 13 4 13 13 4 4 4 4 4 1 1 1 1 1 1 4 4 13 13 13 13 13 2 13 13 13 13 2 2 2 2 2 2 2 2 2 2 2 2 2 2 2 2 2 2 2 2 2 2 2 2 2 2 2 2 2 2
2 2 2 2 2 2 2 2 2 2 2 2 2 2 2 2 2 2 2 2 2 2 2 2 2 2 2 2 2 2 2 2 2 2 2 2 2 2 2 2 2 2 2 13 13 13 13 13 4 4 4 4 4 4 4 4 4 4 4 4 4 4 4 4 13 4 4 4 4 13 13 13 13 2 2 2 2 2 2 2 2 2 2 2 2 2 2 2 2 2 2 2 2 2 2 2 2 2 2 2
2 2 2 2 2 2 2 2 2 2 2 2 2 2 2 2 2 2 2 2 2 2 2 2 2 2 2 2 2 2 2 2 2 2 2 2 2 2 2 2 2 2 2 2 2 2 2 13 13 13 13 13 13 13 4 4 4 4 4 4 4 4 4 4 4 4 4 4 4 4 13 13 13 2 2 2 2 2 2 2 2 2 2 2 2 2 2 2 2 2 2 2 2 2 2 2 2 2 2 13
2 2 2 2 2 2 2 2 2 2 2 2 2 2 2 2 2 2 2 2 2 2 2 2 2 2 2 2 2 2 2 2 2 2 2 2 2 2 2 2 2 2 2 2 2 2 2 2 2 2 2 2 2 13 4 4 4 4 4 4 4 4 4 4 4 4 4 4 4 4 4 13 13 13 2 2 2 2 2 2 2 2 2 2 2 2 2 2 2 2 2 2 2 2 2 13 2 2 2 2
2 2 2 2 2 2 2 2 2 2 2 2 2 2 2 2 2 2 2 2 2 2 2 2 2 2 2 2 2 2 2 2 2 2 2 2 1 1 1 1 1 1 1 1 1 1 1 1 1 1 1 1 2 11 11 11 11 11 11 11 11 11 11 11 11 11 11 11 11 11 11 11 11 11 2 2 2 2 2 2 2 2 2 2 2 2 2 2 2 2 2 2 2 2 2 2 2 13 13 13
2 2 2 2 2 2 2 2 2 2 2 2 2 2 2 2 2 2 2 2 2 2 2 2 2 2 2 2 2 2 2 2 13 13 13 13 13 13 4 4 4 4 4 4 4 4 4 4 4 4 4 4 1 4 4 4 4 4 4 4 4 4 4 4 4 4 4 4 4 4 4 4 4 4 2 2 2 2 2 2 2 2 2 13 13 13 13 2 13 13 13 13 13 1 13 13 13 13 13 4
2 2 2 2 2 2 2 2 2 2 2 2 2 2 2 2 2 2 2 2 2 2 2 2 2 2 2 2 13 13 13 13 13 13 13 13 13 13 13 4 4 4 4 4 4 4 4 4 4 4 4 4 1 1 1 1 1 1 1 1 1 1 1 1 1 1 1 1 1 1 4 4 4 4 2 2 13 15 13 2 2 2 2 13 4 13 13 11 4 4 4 4 4 1 4 4 4 4 4 4
2 2 2 2 2 2 2 2 2 2 2 2 2 2 2 2 2 2 2 2 2 2 2 13 13 13 13 13 13 13 13 13 13 13 4 4 4 13 4 4 4 13 4 4 4 13 4 4 4 4 13 4 1 17 17 17 17 1 1 17 17 17 17 17 17 17 17 17 17 1 4 4 4 4 4 12 13 13 13 12 13 13 13 13 13 13 13 11 4 4 4 4 4 1 4 4 4 4 4 4
2 2 2 2 2 2 2 2 2 2 2 2 2 2 2 2 2 2 2 2 2 13 13 13 13 13 13 13 13 13 13 4 4 13 4 4 4 4 4 4 4 4 4 4 4 4 4 4 4 4 4 4 1 17 17 17 17 17 17 17 17 17 17 17 17 17 17 17 17 1 4 4 4 4 4 12 13 13 13 12 4 13 13 13 4 13 4 11 4 4 4 12 4 1 4 4 12 4 4 4
2 2 2 2 2 2 2 2 2 2 2 2 2 2 2 2 2 2 2 13 13 13 13 13 13 13 13 13 13 13 13 4 13 13 4 4 4 4 4 4 4 4 4 4 4 4 4 4 4 4 4 4 1 1 1 1 1 1 1 1 1 1 17 17 1 1 1 1 1 1 4 4 4 4 4 12 13 13 13 12 4 4 13 4 4 4 4 11 4 4 4 4 4 1 4 4 4 4 4 4
2 2 2 2 2 2 2 2 2 2 2 2 2 2 2 2 2 13 13 13 13 4 4 4 13 4 4 4 4 13 13 13 4 13 4 4 4 4 4 4 4 4 4 4 4 4 4 4 4 4 4 4 13 17 17 17 17 17 17 17 17 1 17 17 17 17 17 17 17 1 4 4 4 4 12 12 4 4 4 12 12 4 4 4 1 1 4 11 4 4 4 4 4 1 4 4 4 4 4 4
2 2 2 2 2 2 2 2 2 2 2 2 2 2 2 2 13 13 13 13 4 4 13 4 13 4 13 13 13 13 13 4 4 4 4 4 4 4 4 4 4 4 4 4 13 4 4 4 4 4 4 4 13 17 17 17 17 17 17 17 17 1 17 17 17 17 17 17 17 1 4 4 4 4 4 12 4 4 4 4 4 12 4 4 1 1 13 11 4 4 4 4 4 1 4 4 4 4 12 4
2 2 2 2 2 2 2 2 2 2 2 2 2 2 2 13 13 13 13 4 13 4 4 4 13 4 13 4 13 13 4 4 4 4 4 4 4 4 13 4 13 4 4 4 4 4 4 4 4 4 4 4 13 17 1 1 1 1 1 1 1 1 1 1 1 1 1 17 17 1 4 4 4 4 4 12 4 4 4 4 4 12 12 4 1 1 4 11 4 4 12 4 4 1 4 12 4 4 4 4
2 2 2 2 2 2 2 2 2 2 2 2 2 2 13 13 13 13 13 13 13 13 13 4 4 4 13 13 4 4 4 4 4 4 4 4 4 4 4 4 4 4 4 4 4 4 4 4 4 4 4 4 13 17 17 17 17 17 17 17 17 1 17 17 17 17 17 17 17 1 4 4 4 4 4 12 4 4 4 4 4 4 12 4 1 1 4 11 4 4 4 4 4 1 4 4 12 4 4 4
2 2 2 2 2 2 2 2 2 2 2 2 2 2 13 13 13 13 13 4 4 13 4 13 13 13 13 4 4 4 4 4 4 4 4 4 4 4 4 4 4 4 4 4 12 12 12 12 12 12 12 12 1 17 17 17 17 17 17 17 17 1 17 17 17 17 17 17 17 1 4 4 4 4 4 12 4 4 4 4 4 4 12 4 1 1 4 1 1 1 4 4 4 1 4 4 4 4 1 1
13 13 2 2 2 2 2 2 2 2 2 2 2 2 13 13 13 13 13 13 13 13 13 13 13 13 4 4 13 4 4 4 4 4 4 13 4 4 4 4 4 12 12 12 12 4 4 4 4 4 4 4 1 1 1 1 1 1 1 17 17 1 17 17 17 17 17 17 17 1 4 4 4 4 4 12 4 4 4 4 4 4 12 4 1 1 4 11 4 1 1 1 1 1 1 1 1 1 1 4
4 13 13 13 2 2 2 2 13 13 13 13 11 13 13 13 13 4 13 13 13 4 4 4 4 4 4 4 4 4 4 4 4 4 4 4 4 4 4 4 12 12 12 4 4 4 4 4 4 4 4 4 1 17 17 1 17 17 17 17 17 1 17 17 1 1 1 1 1 1 4 4 4 4 4 12 4 4 4 4 4 4 12 4 1 1 4 11 4 4 4 4 4 4 1 4 4 4 4 4
4 4 4 13 13 13 13 13 13 4 13 4 11 4 13 13 4 4 13 13 4 4 13 4 4 4 13 4 4 4 4 4 4 4 4 4 12 12 12 12 12 4 4 4 4 4 4 4 4 4 4 4 1 17 17 1 17 17 17 17 17 1 17 17 17 17 17 17 17 1 4 4 4 4 4 12 4 4 4 4 4 4 12 4 1 1 4 11 4 4 12 4 4 4 1 4 4 4 4 4
4 13 13 13 13 13 13 13 4 4 13 4 11 13 13 13 13 13 4 4 4 4 4 4 4 4 4 4 4 4 4 4 4 12 12 12 12 4 4 4 4 4 4 4 4 4 4 4 4 4 4 4 1 17 17 1 17 17 17 17 17 17 17 1 17 17 17 17 17 1 4 4 4 4 4 12 12 4 4 12 12 12 12 4 1 1 4 11 4 4 4 4 4 4 1 4 4 4 4 4
13 13 13 13 13 13 4 4 13 13 13 4 11 13 13 13 13 13 4 4 4 4 4 4 4 4 4 4 13 4 4 12 12 12 4 4 4 4 4 4 4 4 4 4 4 4 4 4 4 4 4 4 1 17 1 1 1 17 1 17 17 17 17 1 17 17 1 1 1 1 4 4 4 4 4 1 4 4 4 4 4 4 4 4 1 1 4 11 4 4 4 4 4 4 1 4 4 4 4 4
13 13 13 13 13 4 4 4 13 4 4 4 11 4 4 4 4 4 4 4 13 4 4 4 4 4 4 4 4 4 4 12 12 4 4 4 4 4 4 4 4 4 4 4 4 4 4 4 4 4 4 4 13 17 17 17 17 17 1 17 17 17 17 1 17 17 17 17 17 1 4 4 4 4 4 1 4 4 4 4 4 4 4 4 1 1 4 11 4 4 4 4 4 4 1 4 4 4 4 4
4 4 4 4 4 4 4 4 4 4 4 4 11 4 4 4 4 4 4 4 4 4 4 4 4 4 4 4 4 12 12 12 4 4 4 4 4 4 4 4 4 4 4 4 4 4 4 4 4 4 4 4 1 17 17 17 17 17 1 17 17 17 17 1 17 17 17 17 17 1 4 4 4 4 4 1 1 1 1 1 1 1 1 1 1 1 4 11 4 4 4 4 4 4 1 4 4 4 12 4
4 4 4 4 4 4 4 4 4 4 4 4 11 4 4 4 4 4 4 4 4 4 4 4 4 4 4 12 12 12 4 4 4 4 4 4 4 4 4 4 4 4 4 4 4 4 4 4 4 4 4 4 1 1 1 1 1 1 1 1 1 1 1 1 1 1 1 1 1 1 4 4 4 4 1 1 1 1 1 1 1 1 1 1 1 1 4 11 4 4 12 4 4 4 1 4 4 4 4 4
4 4 4 11 4 4 4 4 4 4 4 4 11 4 13 4 4 4 4 4 4 13 4 4 4 12 12 12 4 4 4 4 4 4 4 4 4 4 4 4 4 4 4 4 4 4 4 4 4 4 4 4 4 4 4 4 4 4 4 4 4 4 4 4 4 4 4 4 4 4 4 4 4 4 1 1 1 1 1 1 1 1 1 1 1 1 4 11 4 4 4 4 4 4 1 4 4 4 4 12
4 4 4 4 4 4 4 4 4 4 13 4 11 4 4 4 4 4 4 4 4 4 4 4 12 12 4 4 4 4 4 4 4 4 4 4 4 4 4 4 4 4 4 4 4 12 4 4 4 4 4 4 12 4 4 4 4 12 4 4 4 4 4 4 4 4 4 4 4 4 4 4 4 4 1 1 1 1 1 1 1 1 1 1 1 1 4 11 4 4 4 4 4 4 1 4 12 4 4 4
4 4 4 4 4 4 4 4 13 4 4 4 11 4 4 4 4 4 13 4 4 4 4 4 12 12 12 4 4 4 4 4 4 4 4 4 4 4 4 4 4 4 4 4 4 4 4 4 12 4 4 4 4 4 4 4 4 4 4 4 4 4 4 4 4 4 4 4 4 4 4 4 4 4 1 1 1 1 1 1 1 1 1 1 1 1 4 11 4 4 4 4 4 4 1 4 4 4 4 4
4 13 13 4 4 4 4 4 13 4 4 4 11 4 4 4 4 4 4 4 4 4 4 4 4 4 12 12 12 12 4 4 4 4 4 4 4 4 4 4 4 4 4 4 4 4 4 4 4 4 4 4 12 4 4 4 4 4 4 12 4 4 4 4 4 4 4 4 4 4 4 4 4 4 4 4 4 4 4 4 4 4 4 4 4 1 4 11 4 4 4 4 4 4 1 4 4 4 4 4
4 4 4 4 13 4 4 4 4 4 4 4 11 4 4 4 4 4 4 4 4 4 4 4 4 4 4 4 4 12 12 12 4 4 4 4 4 4 4 4 4 4 4 4 4 4 4 4 4 4 4 4 4 4 4 4 4 4 4 4 4 4 12 12 12 12 12 12 12 12 12 12 12 12 12 12 12 12 12 12 12 12 12 12 4 1 4 11 4 4 4 4 4 4 1 4 4 4 4 4
13 4 4 4 4 4 4 4 4 4 4 4 11 4 4 4 4 4 4 4 4 4 4 4 4 4 4 4 4 4 4 12 12 12 4 4 4 4 4 4 4 4 4 12 4 4 4 4 12 4 4 4 4 12 4 4 12 4 12 12 12 12 12 12 12 12 12 12 12 12 12 12 12 12 12 12 12 12 12 12 12 12 12 12 4 1 4 11 4 4 12 4 4 1 1 4 4 4 4 4
4 4 4 4 4 4 4 4 4 11 4 4 11 4 4 4 4 4 4 4 4 4 4 4 4 4 4 4 4 4 4 4 4 12 12 12 4 4 4 4 4 4 4 4 4 4 4 4 4 4 12 4 4 4 4 4 4 4 12 12 12 12 12 12 12 12 12 12 12 12 12 12 12 12 12 12 12 12 12 12 12 12 12 12 4 1 4 11 4 4 4 4 4 1 12 4 4 4 12 4
4 4 4 4 4 4 4 4 4 4 4 4 11 4 4 4 4 4 4 4 4 4 13 4 4 4 4 4 13 4 4 4 4 4 4 12 12 12 4 4 4 4 4 4 4 4 4 4 4 4 4 4 4 4 4 4 4 4 12 12 12 12 12 12 12 12 12 12 12 12 12 12 12 12 12 12 12 12 12 12 12 12 12 12 4 1 4 11 4 4 4 4 4 1 1 4 4 4 4 4
4 4 4 11 4 4 4 13 13 4 4 4 11 4 4 4 13 4 4 4 4 4 4 4 4 4 4 4 4 4 4 4 4 4 4 4 4 12 12 12 4 4 4 4 12 4 4 12 4 4 4 4 4 4 12 4 4 4 4 12 12 12 12 12 12 12 12 12 12 12 12 12 12 12 12 12 12 12 12 12 12 12 12 4 4 1 4 11 12 4 4 4 4 4 1 4 4 4 4 4
4 4 4 4 4 4 4 4 4 4 4 4 11 4 4 4 4 4 4 4 4 4 4 4 4 4 4 4 4 4 4 4 4 4 4 4 4 4 4 4 12 12 12 12 12 12 4 4 4 4 4 12 4 4 4 4 4 4 4 4 4 4 4 12 12 12 12 12 12 12 12 4 4 4 12 12 12 12 12 12 12 12 12 4 1 1 4 11 4 4 4 4 4 4 1 4 4 4 4 4
4 4 4 4 4 4 4 4 4 4 4 4 11 4 4 4 4 4 4 4 4 4 4 4 4 4 13 4 4 4 4 4 4 4 13 4 4 4 4 4 4 4 4 4 4 12 12 12 12 12 4 4 4 4 4 4 4 4 4 4 4 4 4 4 4 4 4 4 4 4 4 4 4 4 12 12 12 12 12 12 12 12 4 4 4 4 4 11 4 4 12 12 12 12 1 12 12 12 12 12
4 4 4 4 4 4 4 4 4 4 4 4 11 4 4 4 4 4 4 4 4 4 4 4 4 4 4 4 4 4 4 4 4 4 4 4 4 4 4 4 4 4 4 4 4 4 4 4 4 12 12 12 12 12 4 4 4 4 4 4 4 4 4 4 4 4 4 4 4 4 4 4 4 4 12 12 12 12 12 12 12 12 4 4 4 4 4 11 4 12 12 12 12 12 1 1 12 12 12 12
4 4 4 4 4 4 4 4 4 4 4 4 11 11 11 11 11 11 11 11 11 11 11 11 4 4 4 4 4 4 4 4 4 4 4 4 4 4 4 4 4 4 4 4 4 4 4 4 4 4 4 4 4 4 12 12 12 12 12 12 12 12 12 12 12 12 12 12 12 12 12 12 13 13 12 12 12 12 12 12 12 12 12 12 12 12 12 11 12 12 12 12 12 12 1 12 12 12 4 12
4 4 11 4 4 4 4 4 4 4 4 4 11 4 4 4 4 4 4 4 4 4 4 11 11 11 11 11 11 11 11 11 11 11 11 4 4 4 4 4 4 4 4 4 4 4 4 4 4 4 4 4 4 4 4 12 12 12 12 12 12 12 12 12 12 12 12 12 12 12 12 12 13 13 12 12 12 12 12 12 12 12 12 12 12 12 12 11 12 12 12 12 12 12 12 12 12 12 12 12
4 4 4 4 4 4 4 4 4 4 4 4 11 4 4 4 4 4 4 4 4 4 4 4 4 2 2 2 2 2 2 2 2 2 11 11 11 11 12 12 12 12 12 12 4 4 4 4 4 4 4 4 4 4 4 12 13 13 13 13 12 12 12 12 12 12 12 12 12 12 12 12 13 13 12 12 12 12 12 12 12 12 12 12 12 12 12 11 12 12 12 12 12 12 12 12 12 12 12 12
4 4 4 4 4 4 4 4 4 4 4 11 11 4 4 4 4 4 4 4 4 2 2 2 2 2 2 2 2 2 2 4 4 4 2 2 2 2 11 11 4 4 4 12 12 12 12 4 4 4 4 4 4 4 4 12 13 13 13 13 13 13 13 13 13 13 13 13 13 13 13 13 13 13 12 12 12 12 12 12 12 12 12 12 12 12 12 12 12 12 12 12 12 12 12 12 12 12 12 12
4 13 4 4 4 4 4 4 4 13 4 4 11 4 4 4 4 4 4 2 2 2 2 2 2 2 2 2 2 2 2 4 2 4 2 2 2 2 2 2 4 4 4 4 4 4 12 12 12 4 4 4 4 4 4 12 13 13 13 13 13 12 12 12 12 12 12 12 12 12 12 12 13 13 12 12 12 12 12 12 12 12 12 12 12 12 12 12 12 12 12 12 12 12 12 12 12 12 12 12
4 4 4 4 4 4 4 4 4 4 4 4 11 4 4 4 4 4 2 2 2 2 2 2 2 2 2 2 2 2 2 4 2 4 4 4 4 4 4 4 4 4 4 4 4 4 4 4 12 12 4 4 4 4 4 12 13 13 13 13 13 12 12 12 12 12 12 12 12 12 12 12 13 13 12 12 12 12 12 12 12 12 12 12 12 12 12 12 12 12 12 12 12 12 12 12 12 12 12 12
4 4 4 4 4 4 4 4 4 4 4 4 11 4 4 4 4 4 4 4 4 4 4 2 2 2 2 2 2 2 2 4 2 2 2 2 2 2 2 2 2 2 4 4 4 4 4 4 4 12 12 4 4 4 4 12 13 13 13 13 13 12 12 12 12 12 12 12 12 12 12 12 13 13 12 12 12 12 12 12 12 12 12 12 12 12 12 12 12 12 12 12 12 12 12 12 12 12 12 12
4 4 4 4 4 4 4 4 4 4 4 4 11 4 4 4 4 2 2 2 2 2 4 4 4 4 2 2 2 2 2 4 2 2 2 2 2 2 2 2 2 2 4 4 4 4 4 4 4 4 12 4 4 4 4 12 12 12 12 12 12 12 12 12 12 12 12 12 12 12 12 12 13 13 12 12 12 12 12 12 12 12 12 12 12 12 12 11 12 12 12 13 12 12 12 12 12 12 12 12
4 4 4 4 4 4 4 4 4 4 4 4 11 4 4 4 4 2 2 2 2 2 2 2 2 4 4 4 4 4 4 4 2 2 2 2 2 2 2 2 2 4 4 4 4 4 4 4 4 4 12 4 4 4 4 12 12 12 13 13 13 13 13 13 13 13 13 13 13 13 13 13 13 13 13 13 13 13 13 13 13 13 13 13 13 12 12 12 12 13 13 13 13 13 12 12 12 12 12 13
4 4 4 4 4 4 4 4 4 4 4 4 11 4 4 4 4 4 4 4 2 2 2 2 2 2 2 2 2 4 4 2 2 2 2 2 2 2 2 2 2 4 4 4 4 4 4 4 4 4 12 4 4 4 4 12 12 12 13 13 13 13 13 13 13 13 13 13 13 13 13 13 13 13 13 13 13 13 13 13 13 13 13 13 13 12 12 11 13 13 13 13 13 13 13 13 13 13 13 13
4 4 4 4 4 4 4 11 4 4 4 4 11 4 4 4 4 4 4 1 1 4 4 2 2 2 2 2 2 2 2 2 2 2 2 2 2 2 2 4 4 4 4 4 4 4 4 4 4 4 12 4 4 4 4 12 12 12 12 12 12 12 12 12 12 12 12 12 12 12 12 12 13 13 12 12 12 12 12 12 12 12 12 12 12 12 12 11 13 13 13 13 13 13 13 13 13 13 13 13
4 4 4 4 4 12 4 4 4 4 4 4 11 4 4 4 4 4 1 1 1 1 1 1 1 1 1 1 1 1 1 1 1 1 1 1 1 1 4 4 4 4 4 4 4 4 4 4 4 4 12 4 4 4 4 12 12 12 12 12 12 12 12 12 12 12 12 12 12 12 12 12 13 13 12 12 12 12 12 12 12 12 12 12 12 12 12 11 13 13 13 13 13 13 13 13 13 13 13 13
4 4 4 4 4 4 4 4 4 4 4 4 11 4 4 4 4 1 1 1 1 1 1 4 4 4 4 4 4 4 4 4 4 4 4 4 4 1 1 1 1 1 1 1 4 4 4 4 4 4 12 4 4 4 4 12 12 12 12 12 12 12 12 12 12 12 12 12 12 12 12 12 13 13 12 12 12 12 12 12 12 12 12 12 12 12 12 11 13 13 13 13 13 13 13 13 13 13 13 13
4 4 4 4 4 4 4 4 4 12 4 4 11 4 4 4 1 1 1 1 1 1 4 4 4 13 4 4 4 13 4 4 13 13 4 4 4 4 4 4 4 4 4 1 1 4 4 4 4 4 12 4 4 4 4 12 12 12 12 12 12 12 12 12 12 12 12 12 12 12 12 12 13 13 12 12 12 12 12 12 12 12 12 12 12 12 12 11 12 12 12 12 12 12 12 12 12 12 12 12
4 4 4 4 4 4 4 4 4 4 4 4 11 4 4 4 1 1 1 1 1 4 4 4 4 4 4 4 4 4 4 4 4 4 4 4 4 4 4 4 4 4 13 4 1 4 4 4 4 4 12 4 4 4 4 12 12 12 13 13 13 13 13 13 13 13 13 13 13 13 13 13 13 13 13 13 13 13 13 13 13 13 13 13 13 12 12 12 12 12 12 12 12 12 12 12 12 12 12 12
4 4 4 4 4 4 4 4 4 4 4 4 11 4 4 1 1 1 1 1 4 4 4 1 1 1 1 1 4 4 13 4 4 4 4 4 4 13 4 4 4 4 4 4 1 12 4 4 4 4 12 4 4 4 4 12 12 12 13 13 13 13 13 13 13 13 13 13 13 13 13 13 13 13 13 13 13 13 13 13 13 13 13 13 13 12 12 12 12 12 12 12 12 12 12 12 12 12 12 12
4 4 4 4 4 4 4 4 4 4 4 4 11 4 4 1 1 1 1 4 4 4 1 1 1 1 1 1 1 4 4 4 4 4 4 13 4 4 4 13 4 4 4 4 1 12 4 4 4 4 12 4 4 4 4 12 12 12 12 12 12 12 12 12 12 12 12 12 12 12 12 12 13 13 12 12 12 12 12 12 12 12 12 12 12 12 12 11 13 13 13 13 13 13 13 13 13 13 13 13
4 4 4 4 12 4 4 4 4 4 4 4 11 4 4 1 1 1 4 4 4 1 1 4 4 4 4 4 1 1 4 4 4 4 13 4 4 4 4 4 4 4 4 4 1 12 4 4 4 4 12 4 4 4 4 12 12 12 12 12 12 12 12 12 12 12 12 12 12 12 12 12 13 13 12 12 12 12 12 12 12 12 12 12 12 12 12 11 13 13 13 13 13 13 13 13 13 13 13 13
4 4 4 4 4 4 4 4 12 4 4 4 11 4 4 1 1 4 4 4 1 1 4 4 4 4 4 4 4 1 1 13 4 4 4 4 4 4 4 4 4 13 4 4 1 12 4 4 4 4 12 4 4 4 4 12 12 12 12 12 12 12 12 12 12 12 12 12 12 12 12 12 13 13 12 12 12 12 12 12 12 12 12 12 12 12 12 11 13 13 13 13 13 13 13 13 13 13 13 13
4 4 4 4 4 4 4 4 4 4 4 4 11 4 4 1 4 4 4 1 1 4 4 4 1 1 1 4 4 4 1 1 4 13 4 4 4 13 4 4 4 4 4 4 1 12 4 4 4 4 12 4 4 4 4 12 12 12 12 12 12 12 12 12 12 12 12 12 12 12 12 12 13 13 12 12 12 12 12 12 12 12 12 12 12 12 12 11 13 13 13 13 13 13 13 13 13 13 13 13
4 4 4 4 4 4 4 4 4 4 4 4 11 4 4 1 4 4 1 1 4 4 4 1 1 1 1 1 4 4 4 1 1 4 4 13 13 4 4 4 4 4 4 4 1 12 4 4 4 4 12 4 4 4 4 12 12 12 12 12 12 12 12 12 12 12 12 12 12 12 12 12 13 13 12 12 12 12 12 12 12 12 12 12 12 12 12 11 13 13 13 13 13 13 13 13 13 13 13 13
4 4 4 4 4 4 4 4 4 4 4 4 11 4 4 1 4 1 1 4 4 4 1 1 2 2 2 1 1 4 4 4 1 1 4 4 4 13 4 4 4 4 4 4 1 11 4 4 4 4 12 4 4 4 4 12 12 12 12 12 12 12 12 12 12 12 12 12 12 12 12 12 13 13 12 12 12 12 12 12 12 12 12 12 12 12 12 11 13 13 13 13 13 13 13 13 13 13 13 13
4 4 4 4 4 4 4 4 4 4 4 4 11 4 4 1 1 1 4 4 4 1 1 2 2 2 2 2 1 1 4 4 4 1 1 4 4 4 4 4 4 4 13 4 1 11 4 4 4 13 12 4 4 4 4 12 12 12 12 12 12 12 12 12 12 12 12 12 12 12 12 12 13 13 12 12 12 12 12 12 12 12 12 12 12 12 12 11 13 13 13 13 13 13 13 13 13 13 13 13
4 4 4 4 4 4 4 4 4 4 4 4 11 4 4 1 1 4 4 4 1 1 2 2 2 2 2 2 2 1 1 4 4 4 1 1 13 4 4 4 13 4 4 4 1 11 4 4 4 4 12 4 4 4 4 12 12 12 12 12 12 12 12 12 12 12 12 12 12 12 12 12 13 13 12 12 12 12 12 12 12 12 12 12 12 12 12 11 13 13 13 13 13 13 13 13 13 13 13 13
4 4 4 4 4 4 4 4 4 12 4 4 11 4 4 4 4 4 13 13 2 2 2 2 2 2 2 2 2 2 2 13 13 4 4 4 4 4 4 4 13 4 4 13 1 11 4 4 4 4 12 4 4 12 4 4 4 4 4 4 4 4 4 4 4 4 4 4 4 4 4 4 4 4 4 4 4 4 4 4 4 4 4 4 4 4 4 11 13 4 4 4 4 4 13 13 13 13 13 13
4 4 4 4 12 4 4 4 4 4 4 4 11 4 4 4 4 13 13 13 2 2 2 2 2 2 2 2 2 2 2 13 13 13 13 4 4 4 4 4 4 4 4 4 1 11 4 4 4 4 12 4 4 4 12 4 4 4 4 4 4 12 4 4 4 4 4 4 4 4 4 4 4 4 4 4 4 4 4 4 4 4 4 4 13 4 4 11 4 4 4 4 4 4 4 13 13 13 13 13
4 4 4 4 4 4 4 4 4 4 4 4 1 1 1 1 1 1 1 1 1 1 1 1 1 1 1 1 1 1 1 1 1 1 1 1 1 1 1 1 1 1 1 1 1 11 4 4 4 4 12 4 4 4 4 12 4 12 4 4 4 4 4 4 4 4 4 4 12 4 4 4 4 4 4 4 4 4 13 4 4 4 4 4 4 4 4 11 4 4 4 4 4 4 4 13 13 13 13 13
4 4 4 4 4 4 4 4 4 4 4 4 1 4 13 13 4 4 13 4 4 4 13 4 4 4 4 4 4 4 4 4 4 4 4 4 4 4 4 4 4 4 4 4 4 11 4 4 4 4 12 4 4 4 4 4 4 4 4 4 4 4 4 4 4 4 4 4 4 13 4 4 4 4 4 4 4 4 4 4 4 4 4 4 4 4 4 11 4 4 4 4 4 4 4 4 13 13 13 13
4 4 4 4 4 4 4 4 4 4 4 4 1 13 13 4 13 4 13 4 13 4 4 4 4 13 4 4 4 4 4 4 4 4 4 4 4 4 4 4 4 4 4 4 4 11 13 4 4 4 12 4 4 4 4 4 4 4 4 4 4 12 4 4 4 4 4 4 4 4 4 4 4 4 4 4 4 4 4 4 4 4 12 4 4 4 4 11 4 4 4 4 4 4 4 4 4 4 4 4
4 4 12 4 4 4 4 4 4 4 4 4 1 13 13 1 1 1 1 1 1 1 1 1 1 1 4 4 4 4 4 4 4 4 4 4 4 4 4 4 4 4 4 4 4 11 4 4 4 4 12 4 4 4 4 4 12 4 4 4 4 4 4 4 4 4 4 4 4 4 4 4 4 4 4 4 4 4 4 4 4 4 4 4 4 4 4 11 4 4 4 4 4 4 4 4 4 4 4 4
4 4 4 4 4 4 4 4 12 4 4 4 1 13 13 13 13 13 13 17 17 17 17 17 17 1 4 1 1 1 4 4 4 4 4 4 4 4 4 4 4 4 4 4 4 11 4 4 4 4 12 12 12 4 4 4 4 4 4 4 4 4 12 4 4 4 4 4 4 4 4 4 4 4 4 4 4 13 4 4 4 4 4 4 4 12 4 11 4 4 4 4 4 4 4 4 4 4 4 4
4 4 4 4 4 4 4 4 4 4 4 4 1 13 13 13 13 13 13 1 17 17 17 17 17 1 4 1 4 4 4 4 4 4 4 4 4 4 4 4 4 4 4 4 4 11 4 4 4 4 12 12 12 12 12 12 12 12 12 12 12 4 4 4 4 4 4 4 4 12 4 4 4 4 12 4 4 4 4 4 4 4 4 4 4 4 4 11 4 4 4 4 4 4 4 4 4 11 4 4
4 4 4 4 4 4 4 4 4 4 4 4 1 13 13 13 13 13 13 1 17 17 17 17 17 1 4 1 4 4 4 4 4 4 4 4 4 4 4 4 4 4 4 4 4 11 4 4 4 4 4 4 4 4 4 4 4 4 4 4 4 4 4 4 4 4 4 4 4 4 4 4 4 4 4 4 4 4 4 4 4 4 4 13 4 4 4 11 4 4 4 4 4 4 4 4 4 4 4 4
4 4 4 4 4 12 4 4 4 4 4 4 1 1 1 1 1 1 1 1 17 17 17 17 17 1 4 1 4 4 4 4 4 4 4 4 4 4 4 4 4 4 4 4 4 11 13 4 4 4 13 4 4 4 4 4 4 4 4 4 4 4 4 4 4 4 4 4 4 13 4 4 4 4 4 4 4 4 4 4 12 4 4 4 4 4 4 11 4 4 4 4 4 4 4 4 4 4 4 4
4 4 4 4 4 4 4 4 4 4 4 4 11 4 4 4 4 4 4 1 17 17 17 17 17 1 4 1 4 4 4 4 4 4 4 4 4 4 4 4 4 4 4 4 4 11 4 4 4 4 4 4 4 4 4 4 13 4 4 4 4 4 4 4 4 4 4 4 4 4 4 4 4 4 4 4 4 4 4 4 4 4 4 4 4 4 4 11 11 4 4 4 4 4 4 4 4 4 4 4
12 12 12 12 12 12 12 12 12 12 12 12 11 4 4 4 4 4 4 1 17 17 17 17 17 1 4 1 4 4 4 4 4 4 4 4 4 4 4 4 4 4 4 4 4 11 4 4 4 4 4 4 4 4 4 4 4 4 4 4 4 4 4 4 4 4 4 4 4 4 4 4 4 4 12 4 4 4 12 4 4 4 4 4 4 4 4 11 4 4 4 4 11 4 4 4 4 4 4 4
12 12 12 12 12 12 12 12 12 12 12 12 11 4 4 4 4 4 4 1 17 17 17 17 17 1 4 1 4 4 4 4 11 4 4 4 4 4 11 11 11 11 11 11 11 11 11 11 11 11 11 11 11 11 11 11 11 11 11 11 11 4 4 4 4 4 4 12 4 4 4 4 4 4 4 4 4 4 4 4 4 4 4 12 4 4 4 11 4 4 4 4 4 4 4 4 4 4 11 4
12 12 12 12 12 12 12 12 12 12 12 12 11 4 4 4 4 4 4 1 17 17 17 17 17 1 4 1 4 4 4 4 11 4 4 4 4 4 4 4 4 4 4 4 4 4 4 4 4 4 4 4 4 4 4 4 4 4 4 4 11 4 4 4 4 4 4 4 4 4 4 4 4 4 4 4 4 4 4 4 4 4 4 4 4 4 4 11 4 4 4 4 4 4 4 4 4 4 4 4
12 12 12 12 12 12 12 12 12 12 12 12 11 4 4 4 4 4 4 1 1 1 1 1 1 1 4 1 4 4 4 4 11 4 4 4 4 4 4 4 4 4 4 4 4 4 4 4 4 4 4 4 4 4 4 4 4 4 4 4 11 4 4 4 4 4 4 4 4 4 4 4 4 4 4 4 4 13 4 4 4 4 4 4 4 4 4 11 4 4 4 4 4 4 4 4 4 11 4 4
12 12 12 12 12 12 12 12 12 12 12 12 11 4 4 4 4 4 4 4 4 4 4 4 4 4 4 1 4 4 4 4 11 4 4 4 4 4 11 11 11 11 11 11 11 11 11 11 11 11 11 4 4 4 4 4 4 4 4 4 11 4 4 4 4 4 4 4 4 4 4 4 4 4 4 4 4 4 4 4 4 12 4 4 4 13 4 11 4 4 4 4 4 11 4 4 4 4 4 4
12 12 12 12 12 12 12 12 12 12 12 12 11 12 12 12 4 4 4 4 4 4 4 4 11 4 4 1 4 4 4 4 11 4 4 4 4 4 11 4 4 4 4 4 4 4 4 4 4 4 4 11 4 4 4 4 4 4 4 4 11 4 4 4 11 4 4 4 4 4 4 4 4 4 12 4 4 4 4 4 4 4 4 4 4 4 4 11 4 4 4 4 4 4 4 4 4 4 4 4
12 12 12 12 12 12 12 12 12 12 12 12 11 4 4 12 4 4 4 4 4 11 4 4 11 4 4 1 4 4 4 4 11 4 4 4 4 4 11 4 4 4 4 4 4 4 4 4 4 4 4 4 11 4 4 4 4 4 4 4 11 4 4 4 11 4 4 4 4 4 4 4 4 4 4 4 4 4 4 12 4 4 4 4 4 4 4 11 4 4 4 4 4 4 4 4 4 4 4 4
12 12 12 12 12 12 12 12 12 12 12 12 11 4 4 12 4 4 4 4 4 11 4 4 11 4 4 1 4 4 4 4 11 4 4 4 4 4 11 4 4 4 4 4 4 4 4 4 4 4 4 4 4 11 4 4 4 4 4 4 11 4 4 4 11 4 4 4 12 4 4 4 13 4 4 4 4 4 4 4 4 4 4 4 4 4 4 11 4 4 11 4 4 4 4 4 4 4 4 4
12 12 12 12 12 12 12 12 12 12 12 12 11 4 4 12 4 4 4 4 4 11 4 4 11 4 4 1 4 4 4 4 11 4 4 4 4 4 11 4 4 4 4 4 4 4 4 4 4 4 4 4 4 4 11 4 4 4 4 4 11 4 4 4 11 4 4 4 4 4 4 4 4 4 4 4 4 4 4 4 4 4 4 4 4 4 4 11 4 4 4 4 11 4 4 4 4 4 4 4
12 12 12 12 12 12 12 12 12 12 12 12 11 4 4 12 4 4 4 4 4 11 4 4 11 4 4 1 4 4 4 4 11 4 4 4 4 4 11 4 4 4 4 4 4 4 4 4 4 4 4 4 4 4 4 11 4 4 4 4 11 4 4 4 11 4 4 4 4 4 4 4 4 4 4 4 4 4 4 4 4 4 4 4 12 4 4 11 4 4 4 4 4 4 4 4 4 4 4 4
12 12 12 12 12 12 12 12 12 12 12 12 11 4 4 12 4 4 4 4 4 12 4 4 11 4 4 1 4 4 4 4 12 4 4 4 4 4 11 4 4 4 4 4 4 4 4 4 4 4 4 4 4 4 4 4 11 4 4 4 11 4 4 4 11 4 4 4 4 12 4 4 4 4 4 12 4 4 4 4 4 4 13 12 4 4 4 11 4 4 4 4 4 4 4 4 4 4 4 4
12 12 12 12 12 12 12 12 12 12 12 12 11 4 4 12 4 12 12 12 4 12 4 4 11 4 4 1 4 4 4 12 4 4 4 4 4 4 11 4 4 4 4 4 4 4 4 4 4 4 4 4 4 4 4 4 4 11 4 4 11 4 4 4 11 4 4 4 4 4 4 4 4 4 4 4 4 4 4 12 4 4 4 4 4 4 4 11 4 4 4 4 4 4 11 4 4 4 11 4
12 12 12 12 12 12 12 12 12 12 12 12 11 4 4 12 4 12 4 12 4 12 4 4 12 4 4 1 4 4 12 4 4 4 11 11 4 4 4 11 4 4 4 4 4 4 4 4 4 4 4 4 4 4 4 4 4 4 11 4 11 4 4 4 11 4 4 4 4 4 4 4 4 4 4 4 4 4 4 4 4 4 4 4 4 4 4 11 4 4 4 4 4 4 4 4 4 4 4 4
12 12 12 12 12 12 12 12 12 12 12 12 11 4 4 12 4 12 4 12 4 12 4 4 12 4 4 1 4 12 4 4 4 11 4 4 11 4 4 11 4 4 4 4 4 4 4 4 4 4 4 4 4 4 4 4 4 4 4 11 4 4 4 4 11 4 4 4 4 4 4 4 12 4 13 4 4 4 4 4 4 4 4 4 4 13 4 11 4 4 11 4 4 4 4 4 4 4 4 4
12 12 12 12 12 12 12 12 12 12 12 12 11 4 4 12 4 12 12 12 4 12 4 4 12 4 4 1 12 4 4 4 11 4 4 4 11 4 4 11 11 11 11 11 11 11 11 11 11 11 11 11 11 11 11 11 11 11 11 4 4 4 4 4 11 4 4 4 4 12 4 4 4 4 4 4 4 4 4 4 4 4 4 4 4 4 4 11 4 4 4 4 4 4 4 4 4 4 4 4
12 12 12 12 12 12 12 12 12 12 12 12 11 4 4 12 4 4 4 4 4 12 4 4 12 4 4 12 4 4 4 11 4 4 4 4 4 11 4 4 4 4 4 4 4 4 4 4 4 4 4 4 4 4 4 4 4 4 4 4 4 4 4 4 11 4 4 4 4 4 4 4 4 4 4 4 4 12 4 4 4 12 4 12 4 4 4 11 4 4 4 11 4 4 4 4 4 11 4 4
12 12 12 12 12 12 12 12 12 12 12 12 11 13 4 12 4 4 4 4 4 12 4 4 12 4 12 4 4 4 11 4 4 4 12 4 4 4 11 4 4 4 4 4 4 4 4 4 4 4 4 4 4 4 4 4 4 4 4 4 4 4 4 11 4 11 4 4 4 4 4 4 4 4 4 4 4 4 4 4 4 4 4 4 4 4 4 11 4 4 4 4 4 4 4 4 4 4 4 4
12 12 12 12 12 12 12 12 12 12 12 12 11 13 13 12 12 12 12 12 12 12 4 4 12 12 4 4 4 11 4 4 4 12 4 12 4 4 4 11 4 4 4 4 4 4 11 11 11 11 11 11 11 11 11 11 11 11 11 11 11 11 11 4 4 4 11 11 11 11 11 11 11 11 11 11 11 11 11 11 11 11 4 4 13 4 4 11 4 4 4 4 4 4 4 12 4 4 4 4
12 12 12 12 12 12 12 12 12 12 12 12 11 13 13 13 4 4 4 4 4 4 4 4 4 4 4 4 4 4 4 4 12 4 4 4 12 4 4 4 11 4 4 4 4 4 4 4 4 4 4 4 4 4 4 4 4 4 4 4 4 4 4 4 4 4 4 4 4 4 4 4 4 4 4 4 4 4 4 4 4 11 4 4 4 4 4 11 4 4 4 4 4 4 4 4 4 4 4 4
12 12 12 12 12 12 12 12 12 12 12 12 12 16 13 13 13 4 4 4 4 4 4 4 4 4 4 4 4 4 4 12 4 4 4 4 4 12 4 4 11 4 4 4 4 4 4 4 4 4 4 4 4 4 4 4 4 4 4 4 4 4 4 4 4 4 4 4 4 4 4 4 4 4 4 4 4 4 4 4 4 11 4 4 4 4 4 11 4 11 4 4 4 4 4 4 4 4 4 11
12 12 12 12 12 12 12 12 12 12 12 12 11 11 11 11 11 11 11 11 11 11 11 11 11 11 11 11 11 11 11 11 4 4 4 4 4 11 11 11 11 11 11 11 11 11 11 11 11 11 11 11 11 11 11 11 11 11 11 11 11 11 11 11 11 11 11 11 11 11 11 11 11 11 11 11 11 11 11 11 11 11 11 11 11 11 11 11 4 4 4 4 11 4 4 4 4 4 4 4
12 12 12 12 12 12 12 12 12 12 12 12 12 12 12 12 12 12 12 12 12 12 12 12 12 12 12 12 4 4 4 4 4 4 4 4 4 4 4 4 4 4 4 4 4 4 4 4 4 4 4 4 4 4 4 4 4 4 4 4 4 4 4 4 4 4 4 4 4 4 4 4 4 4 4 4 4 4 4 4 4 4 4 4 4 4 4 4 4 4 4 4 4 4 4 4 4 4 4 4
12 12 12 12 12 12 12 12 12 12 12 12 12 12 12 12 12 12 12 12 12 12 12 12 12 12 12 4 4 4 4 1 1 4 4 4 4 4 4 4 4 4 4 4 4 4 4 4 4 4 4 12 4 4 4 4 4 13 13 13 13 13 13 13 13 13 13 13 13 13 4 4 4 4 4 4 4 12 4 4 4 4 12 4 4 4 4 4 4 4 4 4 4 4 4 4 12 4 4 4
12 12 12 12 12 12 12 12 12 12 12 12 12 12 12 12 12 1 1 1 1 1 1 1 1 1 1 1 1 1 1 1 1 1 1 1 1 1 1 1 1 1 1 1 1 1 1 1 1 1 1 1 13 13 13 13 13 13 2 2 2 2 2 2 2 2 13 13 13 13 13 13 13 13 13 13 4 4 4 4 4 4 4 4 4 4 4 4 12 4 4 4 4 4 4 4 4 4 4 4
12 12 12 12 12 12 12 12 12 12 12 12 12 12 12 12 12 1 1 1 1 1 1 1 1 1 1 1 1 1 1 1 1 1 1 1 1 1 1 1 1 1 1 1 1 1 1 1 1 1 1 1 1 1 1 2 2 2 2 2 2 2 2 2 2 2 2 2 2 2 2 2 13 13 13 13 13 13 13 4 4 4 12 4 4 4 4 4 4 4 12 4 12 4 4 4 4 12 4 4
12 12 12 12 12 12 12 12 12 12 12 12 12 12 12 12 12 12 12 12 12 1 1 1 1 1 1 1 1 1 1 1 1 1 1 1 1 1 1 1 1 1 1 1 1 1 1 1 1 1 1 1 1 2 2 2 2 2 2 2 2 2 2 2 2 2 2 2 2 2 2 2 2 13 13 13 13 13 13 4 4 4 4 4 4 4 4 4 4 4 4 4 4 4 4 4 4 4 4 4
12 12 12 12 12 12 12 12 12 12 12 12 12 12 12 12 12 12 12 12 12 12 12 12 2 2 2 2 2 2 2 2 2 2 2 2 2 2 2 2 2 2 2 2 2 2 2 2 2 2 2 2 2 2 2 2 2 2 2 2 2 2 2 2 2 2 2 2 2 2 2 2 2 2 13 13 13 13 13 4 4 4 4 4 4 4 4 4 4 4 4 4 4 4 4 4 4 4 4 4
