5 5 5 5 5 5 5 5 5 5 5 5 5 5 5 5 5 5 5 5 5 5 5 5 5 5 5 5 5 5 5 5 5 5 5 5 5 5 5 5 5 5 5 5 5 5 5 5 5 5 5 5 5 5 5 5 5 5 5 5 5 5 5 5 5 5 5 5 5 5 5 5 5 5 5 5 5 5 5 5 5 5 5 5 5 5 5 5 5 5 5 5 5 5 5 5 5 5 5 5 
5 5 5 5 5 5 5 5 0 0 0 0 0 0 0 0 0 0 0 0 0 0 0 0 5 5 5 5 5 5 5 5 5 5 5 5 5 5 5 5 5 5 5 5 5 5 5 5 5 5 5 5 5 5 5 5 5 5 5 5 5 5 5 5 5 5 5 5 5 5 5 5 5 5 5 5 5 5 5 5 5 5 5 5 5 5 5 5 5 5 5 5 5 5 5 5 5 5 5 5 
5 5 5 5 5 5 0 0 0 5 5 5 5 5 5 5 5 5 5 5 5 5 5 0 0 0 0 0 0 0 0 0 0 0 0 0 0 0 5 5 5 5 5 5 5 5 5 5 5 5 5 5 5 5 5 5 5 5 5 5 5 5 5 0 0 0 0 0 0 5 5 5 5 5 5 0 0 0 0 0 0 0 0 0 0 5 5 5 5 5 5 5 5 5 5 5 5 5 5 5 
5 5 5 5 0 0 0 0 0 5 5 5 5 5 5 5 5 5 5 5 5 5 5 5 5 5 5 5 5 5 5 5 5 5 5 5 5 0 0 0 0 0 0 0 0 0 0 0 0 0 0 0 0 5 5 5 5 5 5 5 5 5 5 5 5 5 5 5 0 0 0 0 0 0 0 0 5 5 5 5 5 5 5 5 0 0 0 0 0 0 5 5 5 5 5 5 5 5 5 5 
5 5 5 0 0 5 0 0 0 5 5 5 5 5 5 5 5 5 5 2 2 2 2 2 2 2 2 2 2 2 2 2 2 2 2 2 2 2 2 2 2 2 2 2 2 2 2 2 2 2 2 2 2 2 2 2 0 0 0 0 0 0 0 0 0 0 0 0 0 0 0 0 0 0 0 0 5 5 5 5 5 5 5 5 5 5 5 5 5 0 0 0 5 5 5 5 5 5 5 5 
5 5 5 0 5 5 0 5 0 5 5 2 2 2 2 2 2 2 2 2 2 2 2 2 2 2 2 2 2 2 2 2 2 2 2 2 2 2 2 2 2 2 2 2 2 2 2 2 2 2 2 2 2 2 2 2 2 2 2 2 2 2 2 2 2 2 2 2 2 2 2 2 2 2 2 2 2 2 2 5 5 5 5 5 5 5 5 5 5 5 5 5 5 5 5 5 5 5 5 5 
5 5 5 0 5 5 0 5 0 2 2 2 2 2 2 2 2 2 2 2 2 2 2 2 2 2 2 2 2 2 2 2 2 2 2 2 2 2 2 2 2 2 2 2 2 2 2 2 2 2 2 2 2 2 2 2 2 2 2 2 2 2 2 2 2 2 2 2 2 2 2 2 2 2 2 2 2 2 2 2 2 2 2 5 5 5 5 5 5 5 5 5 5 5 5 5 5 5 5 5 
5 5 0 0 5 5 5 0 2 2 2 2 2 2 2 2 2 2 2 2 2 2 2 2 2 2 2 2 2 2 2 2 2 2 2 2 2 2 2 2 2 2 2 2 2 2 2 2 2 2 2 2 2 2 2 2 2 2 2 2 2 2 2 2 2 2 2 2 2 2 2 2 2 2 2 2 2 2 2 2 2 2 2 2 1 1 1 1 5 5 5 5 5 0 5 5 5 5 5 5 
5 5 0 5 5 5 5 0 2 2 2 2 2 5 5 5 5 5 5 5 5 5 5 5 5 5 5 5 5 5 5 5 5 5 5 5 5 5 5 5 5 5 5 5 5 5 5 5 5 5 5 5 5 5 5 5 5 5 5 5 5 5 5 5 5 5 5 5 5 5 5 5 0 0 0 0 0 0 0 0 0 0 0 0 0 0 05 1 5 5 5 5 5 0 5 5 5 5 5 5 
5 5 0 5 5 5 5 0 2 2 2 2 2 5 1 1 1 1 1 1 1 1 1 1 1 1 1 1 1 1 1 1 1 1 1 1 1 1 5 0 0 0 0 0 0 0 0 0 0 0 0 0 0 0 0 0 0 0 5 5 5 5 5 0 0 0 0 0 5 5 5 5 0 0 0 0 0 0 0 0 0 0 0 0 0 0 0 1 5 5 5 5 5 0 5 5 5 5 5 5 
5 5 0 5 5 5 5 0 2 2 2 2 2 5 1 0 0 0 0 0 0 0 0 0 0 0 0 0 0 0 0 0 0 0 0 0 0 1 5 0 0 0 0 0 0 0 0 0 0 0 0 0 0 0 0 0 0 0 0 0 0 0 0 0 0 0 0 0 0 5 5 5 5 0 0 0 5 5 5 5 5 5 5 5 5 0 0 1 5 5 5 5 5 0 5 5 5 5 5 5 
5 5 0 5 5 5 5 0 2 2 2 2 2 5 1 0 0 0 0 1 1 1 1 1 1 1 1 1 1 1 1 1 1 1 1 0 0 1 5 0 0 0 0 5 5 5 5 5 5 5 0 0 0 0 0 0 0 0 0 0 0 0 0 0 0 0 0 0 0 0 5 5 5 0 0 0 5 5 5 5 5 5 5 5 5 0 0 1 5 5 5 5 5 5 0 5 5 5 5 5 
5 5 0 5 5 5 5 2 2 2 2 2 2 5 1 0 0 1 1 1 0 0 0 0 0 0 0 0 0 0 0 0 0 0 1 0 0 1 5 0 0 0 5 5 5 5 5 5 5 5 5 5 5 5 5 5 5 5 5 5 5 5 5 5 5 5 5 0 0 0 0 5 5 5 0 0 5 5 5 5 5 5 5 5 5 0 0 5 5 5 5 5 5 5 0 5 5 5 5 5 
5 5 0 0 5 5 2 2 2 2 2 2 2 5 1 0 0 1 0 0 0 0 0 0 0 1 1 1 1 1 1 1 1 0 1 1 0 1 5 0 0 0 5 5 5 5 5 5 5 5 5 5 5 5 5 5 5 5 5 5 5 5 5 5 5 5 5 0 0 0 0 5 5 5 0 0 5 5 5 5 5 5 5 5 5 0 0 5 5 5 5 5 5 5 5 0 5 5 5 5 
5 5 5 0 5 5 2 2 2 2 2 2 2 5 1 0 0 1 0 0 0 0 0 1 1 1 0 0 0 0 0 0 1 0 0 1 0 1 5 0 0 0 5 5 0 0 0 0 0 0 2 2 2 2 2 2 2 2 2 2 2 2 2 2 2 5 5 0 0 0 0 5 5 5 0 0 5 5 5 5 5 5 5 5 5 0 0 5 5 5 5 5 5 5 5 0 0 5 5 5 
5 5 5 0 0 5 2 2 2 2 2 2 2 5 1 0 0 1 0 0 0 1 1 1 0 0 0 0 0 0 0 0 1 1 0 1 0 1 5 0 0 0 5 5 0 2 2 2 2 2 2 2 2 2 2 2 2 2 2 2 2 2 2 2 2 5 5 5 0 0 0 5 5 5 0 0 0 5 5 5 5 5 5 5 0 0 0 5 5 5 5 5 5 5 5 5 0 0 5 5 
5 5 5 5 0 0 2 2 2 2 2 2 2 5 1 0 0 1 0 0 0 1 0 0 0 0 1 1 1 1 0 0 0 1 0 1 0 1 5 0 0 0 5 5 0 2 2 2 2 2 2 2 2 2 2 2 2 2 2 2 2 2 2 2 0 5 5 5 0 0 0 5 5 5 0 0 0 0 0 5 5 5 5 5 0 0 0 5 5 5 5 5 5 5 5 5 5 0 5 5 
5 5 5 5 0 2 2 2 2 2 2 2 2 5 1 0 0 1 0 0 1 1 0 0 0 1 1 0 0 0 0 0 0 1 0 1 0 1 5 0 0 0 5 5 0 2 2 2 2 2 2 2 2 2 2 2 2 2 2 2 2 2 0 0 5 5 5 5 0 0 0 5 5 5 0 0 0 0 0 0 0 0 0 0 0 0 0 5 5 5 5 5 5 5 5 5 5 0 5 5 
5 5 5 5 0 2 2 2 2 2 2 2 2 5 1 0 1 1 0 0 1 0 0 0 0 1 3 0 0 0 0 0 1 1 0 1 0 1 5 0 0 5 5 5 5 5 5 5 5 5 5 5 0 0 0 0 0 0 0 0 0 5 5 5 5 5 5 5 0 0 0 5 5 5 0 0 0 0 0 0 0 0 0 0 0 0 0 5 5 5 5 5 5 5 5 5 5 0 5 5 
5 5 5 5 0 2 2 2 2 2 2 2 2 5 1 0 1 0 0 0 1 0 0 0 0 1 1 1 1 1 1 1 1 0 0 1 0 1 5 0 0 5 5 5 5 5 5 5 5 5 5 5 5 5 5 5 5 5 5 5 5 5 5 5 5 5 5 5 0 0 0 5 5 5 5 0 0 0 0 0 0 0 0 0 0 0 0 5 5 5 5 5 5 5 5 5 5 0 5 5 
5 5 5 5 0 2 2 2 2 2 2 2 2 5 1 0 1 0 0 0 1 1 1 0 0 0 0 0 0 0 0 0 0 0 0 1 0 1 5 0 0 5 5 5 5 5 5 5 5 5 5 5 5 5 5 5 5 5 5 5 5 5 0 0 0 0 0 0 0 0 0 5 5 5 5 0 0 0 0 5 5 5 5 5 5 5 5 5 5 5 5 5 5 5 5 5 5 0 5 5 
5 5 5 0 0 2 2 2 2 2 2 2 2 5 1 0 1 0 0 0 0 0 1 1 1 1 1 1 1 1 1 1 1 1 1 1 0 1 5 0 0 5 5 5 5 5 0 0 0 0 0 0 0 0 0 0 0 0 0 0 0 0 0 0 0 0 0 0 0 0 0 5 5 5 0 0 0 0 0 5 5 5 5 5 5 5 5 1 5 5 5 5 5 5 5 5 5 0 5 5 
5 5 5 0 2 2 2 2 2 2 2 2 2 5 1 0 1 0 0 0 0 0 0 0 0 0 0 0 0 0 0 0 0 0 0 0 0 1 5 0 0 5 5 0 0 0 0 0 0 0 0 0 0 0 0 0 0 0 0 0 0 0 0 0 0 0 0 0 0 0 0 0 5 5 0 0 0 0 5 5 5 5 5 5 5 5 5 1 5 5 5 5 5 5 5 5 5 0 5 5 
5 5 0 0 2 2 2 2 2 2 2 2 2 5 1 0 1 1 1 1 1 1 1 1 1 1 1 1 1 1 1 1 1 1 1 1 1 1 5 0 0 5 5 5 0 0 0 0 0 0 0 0 0 0 0 0 0 0 0 5 5 5 5 0 0 0 0 0 0 0 0 0 0 0 0 0 0 0 5 5 5 5 0 0 0 0 0 1 5 5 5 5 5 5 5 5 5 0 5 5 
5 5 0 5 5 5 0 2 2 2 2 2 2 5 1 0 1 5 5 5 5 5 5 5 5 5 5 5 5 5 5 5 5 5 5 5 5 5 5 0 0 0 0 5 5 0 0 0 0 0 0 0 0 0 0 0 0 0 5 5 5 5 5 5 5 5 0 0 0 0 0 0 0 0 0 0 0 0 5 5 5 5 0 0 0 0 0 1 5 5 5 5 5 5 5 5 0 0 5 5 
5 5 0 5 5 5 0 2 2 5 5 5 5 5 1 0 1 5 5 5 5 5 5 5 5 5 5 5 5 5 5 5 5 5 5 5 5 5 5 0 0 0 0 0 5 0 0 0 0 0 0 0 0 0 0 0 5 5 5 5 5 5 5 5 0 0 0 0 0 0 0 0 0 0 0 0 0 0 5 5 0 0 0 5 5 0 0 1 5 5 5 5 5 5 5 5 0 5 5 5 
5 5 0 0 5 5 0 5 5 5 5 5 5 5 1 0 1 5 5 5 0 0 0 0 0 0 0 0 0 0 0 0 0 0 0 0 0 0 0 0 0 0 0 0 5 5 5 0 0 0 0 0 0 0 5 5 5 5 5 0 0 5 5 5 0 0 0 0 5 5 0 0 0 0 0 0 0 0 5 5 0 0 5 5 5 0 0 1 5 5 5 5 5 5 5 5 0 5 5 5 
5 5 5 0 0 5 0 5 5 5 5 5 5 5 1 0 1 1 5 5 0 0 0 5 5 5 0 0 0 0 0 0 0 5 5 5 0 0 0 0 0 5 5 5 5 5 5 0 0 0 0 5 5 5 5 5 5 5 0 0 0 0 0 0 0 0 5 5 5 5 5 5 0 0 0 0 0 0 5 5 0 5 5 5 5 0 0 1 5 5 5 5 5 5 5 0 0 5 5 5 
5 5 5 5 0 0 0 5 5 5 5 5 5 5 1 0 0 1 5 5 0 0 0 5 5 5 5 0 0 0 0 0 0 5 5 5 0 0 0 0 0 5 5 5 5 5 5 5 5 5 5 5 5 5 5 5 5 5 5 0 0 0 0 0 0 5 5 5 5 5 5 5 5 0 0 0 0 5 5 0 0 5 5 5 5 0 0 1 5 5 5 5 5 5 5 0 5 5 5 5 
5 5 5 5 5 5 5 5 5 5 5 5 5 5 1 0 0 1 5 5 0 0 0 5 5 5 5 5 5 5 5 5 5 5 5 5 0 0 0 0 0 0 0 0 0 0 0 0 0 0 0 0 0 0 0 0 0 0 5 5 5 0 0 0 5 5 5 5 5 5 5 5 5 0 0 0 0 5 0 0 0 5 5 5 5 0 0 1 5 5 5 5 5 5 5 0 5 5 5 5 
5 5 5 5 5 5 5 5 5 5 5 5 5 5 1 0 0 1 5 5 0 0 5 5 5 5 5 5 5 5 5 5 5 5 5 5 5 5 0 0 0 0 0 0 0 0 0 0 0 0 0 0 0 0 0 0 0 0 0 0 5 0 0 0 5 5 5 5 5 5 5 5 5 0 0 0 0 5 0 0 0 5 5 5 0 0 0 1 5 5 5 5 5 5 5 0 5 5 5 5 
5 5 5 5 5 5 5 5 0 0 5 5 5 5 1 0 0 1 5 5 0 0 5 5 5 5 5 5 5 5 5 5 5 5 5 5 5 5 5 5 5 5 5 5 0 0 0 0 0 0 0 0 0 0 0 0 0 0 0 0 5 0 0 0 5 5 5 5 5 5 5 5 5 0 0 0 0 5 0 0 0 5 5 5 5 0 0 1 5 5 5 5 5 5 5 0 5 5 5 5 
5 5 5 5 5 5 5 5 5 0 5 5 5 5 1 0 0 1 5 5 0 0 5 5 5 5 5 5 5 5 5 5 5 5 5 5 5 5 5 5 5 5 5 5 5 5 0 0 0 0 0 0 0 0 0 0 0 0 0 0 5 0 0 0 5 5 5 5 5 5 5 5 0 0 0 0 0 5 0 0 0 5 5 5 5 0 0 1 5 5 5 5 5 5 5 0 5 5 5 5 
5 5 5 5 5 5 5 5 5 0 5 5 5 5 1 0 0 1 5 5 0 0 5 5 5 5 5 5 5 5 5 5 5 5 5 5 5 5 5 5 5 5 5 5 5 5 5 5 5 5 5 5 5 5 5 5 5 0 0 0 5 0 0 0 5 5 5 5 5 5 5 0 0 0 0 0 0 5 5 0 0 0 5 5 5 0 0 1 5 5 5 5 5 5 5 0 5 5 5 5 
5 5 5 5 5 5 5 5 5 0 5 5 5 5 5 0 0 1 5 5 0 0 5 5 5 5 5 5 5 5 5 5 5 5 5 5 5 5 5 5 5 5 5 5 0 0 0 0 0 0 0 0 0 0 0 0 5 0 0 0 5 0 0 0 5 5 5 5 5 5 5 0 0 0 0 0 0 5 5 0 0 0 5 5 5 0 0 1 5 5 5 5 5 5 5 0 5 5 5 5 
5 5 5 5 5 5 5 5 5 0 5 5 5 5 5 0 0 1 5 5 0 0 5 5 5 5 5 5 5 5 5 5 5 5 5 5 5 5 5 5 5 5 5 0 0 0 0 0 0 0 0 0 0 0 0 0 5 0 0 0 5 5 0 5 5 5 5 5 5 5 5 0 0 0 0 0 0 5 5 0 0 0 5 5 5 0 0 1 5 5 5 5 5 5 5 0 5 5 5 5 
5 5 5 5 5 5 5 5 5 0 5 5 5 5 5 0 0 0 5 5 0 0 5 5 5 5 5 5 5 5 5 5 5 5 0 0 0 0 0 5 5 5 5 5 5 5 5 5 5 5 5 5 0 0 0 0 5 0 0 0 0 5 5 5 5 5 5 5 5 5 5 5 5 0 0 0 0 5 5 0 0 0 5 5 5 0 0 1 5 5 5 5 5 5 5 5 0 5 5 5 
5 5 5 5 5 5 5 5 5 0 5 5 5 5 5 0 0 0 5 5 0 0 0 5 5 5 5 5 5 5 5 5 5 0 0 0 0 0 0 0 0 0 0 0 0 0 0 0 0 0 0 5 0 0 0 0 5 0 0 0 0 5 5 5 5 5 5 5 5 5 5 5 5 0 0 0 0 5 5 0 0 0 5 5 5 0 0 1 5 5 5 5 5 5 5 5 0 5 5 5 
5 5 5 5 5 5 5 5 0 5 5 5 5 5 5 0 0 0 5 5 0 0 0 5 5 5 5 5 5 5 5 5 5 0 0 0 0 0 0 0 0 0 0 0 0 0 0 0 0 0 0 5 0 0 0 0 5 0 0 0 0 5 5 5 5 5 5 5 5 5 5 5 5 5 0 0 0 5 5 0 0 0 5 5 5 0 0 1 5 5 5 5 5 5 5 5 0 5 5 5 
5 5 5 5 5 5 5 5 0 5 5 5 5 5 5 0 0 0 5 5 0 0 0 5 5 5 5 5 5 5 5 5 5 0 5 5 5 5 5 5 5 5 5 5 5 5 5 5 5 0 0 5 0 0 0 0 5 0 0 0 0 5 0 5 5 5 5 5 5 5 5 5 5 5 0 0 0 5 5 0 0 0 5 5 5 0 0 1 5 5 5 5 5 5 5 5 0 5 5 5 
5 5 5 5 5 5 5 0 0 5 5 5 5 5 5 0 0 0 5 5 0 0 0 5 5 5 5 5 5 5 5 5 5 0 5 5 5 5 5 5 5 5 5 5 5 0 0 0 5 0 0 5 0 0 0 0 5 0 0 0 0 5 0 5 5 5 5 5 5 5 5 5 5 5 0 0 0 5 0 0 0 0 5 5 5 0 0 1 5 5 5 5 5 5 5 5 0 5 5 5 
5 5 5 5 5 5 5 0 5 5 5 5 5 5 5 0 0 0 5 5 0 0 0 0 5 5 5 5 5 5 5 5 5 0 5 5 5 5 5 5 5 5 5 5 5 0 0 0 5 0 0 5 0 0 0 0 5 0 0 0 0 5 0 5 5 5 5 5 5 5 5 5 5 0 0 0 5 5 0 0 0 5 5 5 5 5 0 1 5 5 5 5 5 5 5 5 0 5 5 5 
5 5 5 5 5 5 0 0 5 5 5 5 5 5 5 0 0 0 5 5 0 0 0 5 5 5 5 5 5 5 5 5 5 0 5 5 5 5 5 5 5 5 5 5 5 0 0 0 5 0 0 5 0 0 0 0 5 0 0 0 0 5 0 0 0 5 5 5 5 5 0 0 0 0 0 0 5 5 0 0 5 5 5 5 5 5 5 1 5 5 5 5 5 5 5 5 0 5 5 5 
5 5 5 5 5 0 0 5 5 5 5 5 5 5 5 0 0 0 5 5 0 0 0 5 5 5 5 5 5 5 5 5 5 0 5 5 5 5 5 5 5 5 5 5 5 0 0 0 5 0 0 5 0 0 0 0 5 0 0 0 5 5 0 0 0 0 0 0 0 0 0 0 0 0 0 0 5 0 0 0 5 5 5 5 5 5 5 1 5 5 5 5 5 0 5 5 5 5 5 5 
5 5 5 5 5 0 5 5 5 5 5 5 5 5 5 0 0 0 5 5 0 0 0 5 5 5 5 5 5 5 5 5 5 0 5 5 5 5 5 5 5 5 5 5 5 0 0 0 5 0 0 5 0 0 0 0 5 0 0 0 5 0 0 0 0 0 0 0 0 0 0 0 0 5 5 5 5 0 0 0 5 5 5 5 5 5 5 1 5 5 5 5 5 0 0 5 5 5 5 5 
5 5 5 5 5 0 5 5 5 5 5 5 5 5 5 0 0 0 5 5 0 0 0 5 5 5 5 5 5 5 5 5 5 0 5 5 5 5 5 5 5 5 5 5 5 0 0 0 5 0 0 5 0 0 0 0 5 0 0 0 5 0 0 5 5 5 5 5 5 5 0 0 0 5 5 5 5 0 0 5 5 5 5 5 5 5 5 1 5 5 5 5 5 5 0 5 5 5 5 5 
5 5 5 5 5 0 5 5 5 5 5 5 5 5 5 0 0 0 5 5 0 0 0 5 5 5 5 5 5 5 5 5 5 0 5 5 5 5 5 5 5 5 5 5 5 0 0 0 5 0 0 5 0 0 0 0 5 0 5 5 5 0 5 5 5 5 5 5 5 5 5 5 0 0 5 5 5 0 0 5 5 5 5 5 5 5 5 1 5 5 5 5 5 0 0 5 5 5 5 5 
5 5 5 5 5 0 0 5 5 5 5 5 5 5 5 0 0 0 5 5 0 0 5 5 5 5 5 5 5 5 5 5 5 0 5 5 5 5 5 5 5 5 5 5 0 0 0 5 5 0 0 5 5 0 0 0 5 5 5 0 0 0 5 5 5 5 5 5 5 5 5 5 5 0 5 5 5 0 0 5 5 5 5 5 5 5 5 1 5 5 5 5 5 0 5 5 5 5 5 5 
5 5 5 5 5 5 0 5 5 5 5 5 5 5 5 0 0 0 5 5 0 0 5 5 5 5 5 5 5 5 5 5 5 0 5 5 5 5 5 5 5 5 5 0 0 0 5 0 0 0 0 0 0 5 0 0 5 0 0 0 0 0 5 5 5 5 5 5 5 5 5 5 5 0 5 5 5 0 0 5 5 5 5 5 5 5 5 1 5 5 5 5 5 0 5 5 5 5 5 5 
5 5 5 5 5 5 0 0 5 5 5 5 5 5 5 0 0 0 5 5 0 5 5 5 5 5 5 5 5 5 5 5 5 0 5 5 5 5 5 5 5 5 0 0 0 0 5 0 0 3 3 0 0 5 0 0 5 0 0 0 0 0 0 5 5 5 5 5 5 5 5 5 5 0 5 5 0 0 0 0 5 5 5 5 5 5 5 1 5 5 5 5 5 0 5 5 5 5 5 5 
5 5 5 5 5 5 5 0 0 5 5 5 5 5 5 0 0 0 5 5 0 5 5 5 5 5 5 5 5 5 5 5 5 0 5 5 5 5 5 5 5 5 0 0 0 0 5 0 0 3 3 0 0 5 0 0 5 0 0 0 0 0 0 0 0 0 0 0 0 0 0 0 0 0 5 0 0 0 0 0 5 5 5 5 5 5 5 1 5 5 5 5 5 0 5 5 5 5 5 5 
5 5 5 5 5 5 5 5 0 5 5 5 5 5 5 0 0 0 5 5 0 0 5 5 5 5 5 5 5 5 5 5 5 0 5 5 5 5 5 5 5 5 0 0 0 0 5 0 0 0 0 0 0 5 0 0 5 0 0 0 0 0 0 0 0 0 5 5 5 5 5 5 0 0 0 0 0 0 0 0 5 5 5 5 5 5 5 1 5 5 5 5 5 0 5 5 5 5 5 5 
5 5 5 5 5 5 5 5 0 0 5 5 5 5 5 0 0 0 5 5 0 0 0 0 0 0 0 0 0 0 0 0 0 0 5 0 0 0 0 0 0 0 0 0 5 5 5 5 5 5 5 5 5 0 0 0 5 0 0 0 0 0 0 0 0 5 5 5 5 5 5 5 5 0 0 0 0 0 0 0 0 0 5 5 5 5 5 1 5 5 5 5 5 0 5 5 5 5 5 5 
5 5 5 5 5 5 5 5 5 0 5 5 5 5 5 0 0 0 5 5 5 5 5 5 5 5 5 5 5 5 5 5 5 5 5 0 0 0 5 5 5 5 5 5 5 0 0 0 0 0 0 0 0 0 0 5 5 0 0 0 0 0 0 5 5 5 5 5 5 5 5 5 5 5 0 5 0 0 0 0 0 0 5 5 5 5 5 1 5 5 5 5 5 0 0 5 5 5 5 5 
5 5 5 5 5 5 5 5 0 0 5 5 5 5 5 0 0 0 0 0 0 0 0 0 0 0 0 0 0 5 5 5 5 5 0 0 0 5 5 5 0 0 0 0 0 0 0 0 0 0 0 0 0 0 5 5 0 0 0 0 0 0 5 5 5 5 5 5 5 5 5 5 5 5 0 5 5 0 0 0 0 0 0 5 5 5 5 1 5 5 5 5 5 5 0 5 5 5 5 5 
5 5 5 5 5 5 5 5 0 5 5 5 5 5 5 0 0 0 5 5 5 5 5 5 5 5 5 5 5 5 5 5 5 5 5 0 0 5 5 5 0 0 0 0 0 0 0 0 0 0 0 0 0 5 5 0 0 0 0 0 0 0 5 5 5 5 5 5 5 5 5 5 5 0 0 5 5 5 5 0 0 0 0 5 5 5 5 1 5 5 5 5 5 5 0 5 5 5 5 5 
5 5 5 5 5 5 5 5 0 5 5 5 5 5 5 0 0 5 5 5 5 5 5 5 5 5 5 5 5 5 5 5 5 5 5 0 0 5 5 5 0 5 5 5 5 5 5 5 5 5 5 5 5 5 0 0 0 0 0 0 0 0 5 5 5 5 5 5 5 5 5 5 5 5 5 5 5 5 5 5 0 0 0 5 5 5 5 1 5 5 5 5 5 5 0 0 5 5 5 5 
5 5 5 5 5 5 5 0 0 5 5 5 5 5 5 0 0 0 0 0 0 0 5 5 5 5 5 5 5 5 0 0 0 0 0 0 0 5 5 5 0 5 5 5 5 5 5 5 5 5 5 0 0 0 0 0 0 0 0 0 0 0 5 5 5 5 5 5 5 5 5 5 5 5 5 5 5 5 5 5 0 0 0 5 5 5 5 1 5 5 5 5 5 5 5 0 5 5 5 5 
5 5 5 5 5 5 5 0 5 5 5 5 5 5 5 0 0 0 0 0 0 0 0 0 0 0 0 0 0 0 0 0 0 0 0 0 0 5 5 5 0 5 5 5 5 5 5 5 5 0 0 0 5 5 5 5 5 5 0 0 0 0 5 5 5 5 5 5 5 5 5 5 5 5 5 5 5 5 5 5 0 0 0 5 5 5 5 1 5 5 5 5 5 5 5 0 0 5 5 5 
5 5 5 5 5 5 0 0 5 5 5 5 5 5 5 0 0 0 5 5 5 5 5 5 0 5 5 5 5 5 5 5 5 5 5 5 0 0 0 0 0 5 5 5 5 5 5 5 0 0 0 5 5 5 5 5 5 5 5 0 0 0 0 5 5 5 5 5 5 5 5 5 5 5 5 5 5 5 5 5 0 0 0 5 5 5 5 1 5 5 5 5 5 5 5 5 0 5 5 5 
5 5 5 5 5 5 0 5 5 5 5 5 5 5 5 0 0 5 5 5 5 5 5 5 5 5 5 5 5 5 5 5 5 5 5 5 0 0 0 0 0 5 5 5 5 5 0 0 0 0 0 5 5 5 5 5 5 5 5 5 0 0 0 0 0 0 0 5 5 5 5 5 5 5 5 5 5 5 5 5 0 0 0 0 5 5 5 1 5 5 5 5 5 5 5 5 0 5 5 5 
5 5 5 5 5 5 0 5 5 5 5 5 5 5 5 0 0 5 5 5 5 5 5 5 5 5 5 5 5 5 5 5 5 5 5 5 5 5 5 5 5 5 5 5 5 5 5 0 0 0 0 5 5 5 5 5 5 5 5 5 0 0 0 0 0 5 0 0 5 5 5 5 5 5 5 5 5 5 5 5 0 0 0 0 5 5 5 1 5 5 5 5 5 5 5 5 0 5 5 5 
5 5 5 5 5 0 0 5 5 5 5 5 5 5 5 0 0 5 5 5 5 5 5 5 5 5 5 5 5 5 5 5 5 5 5 5 5 5 5 5 5 5 5 5 5 5 5 5 0 0 0 5 5 5 5 5 5 5 5 5 0 0 0 5 5 5 5 0 0 5 5 5 5 5 5 5 5 5 5 5 0 0 0 0 5 5 5 1 5 5 5 5 5 5 5 5 0 5 5 5 
5 5 5 5 5 0 5 5 5 5 5 5 5 0 5 0 0 0 5 5 5 5 5 5 5 5 5 5 5 5 5 5 5 5 5 5 5 5 5 5 5 5 5 5 5 5 5 5 0 0 0 5 5 5 5 5 5 5 5 5 0 0 5 5 5 5 5 5 0 0 5 5 5 5 5 5 5 5 5 0 0 5 5 0 5 5 5 1 5 5 5 5 5 5 5 5 0 5 5 5 
5 5 5 5 5 0 5 5 5 5 5 5 5 0 5 0 0 0 0 5 5 5 5 5 5 5 5 5 5 5 5 5 5 5 5 5 5 5 5 5 5 5 5 5 5 5 5 5 0 0 0 5 5 5 5 5 5 5 5 0 0 0 5 5 5 5 5 5 5 0 0 5 5 5 5 5 5 5 0 0 5 5 5 5 0 5 5 1 5 5 5 5 5 5 5 0 0 5 5 5 
5 5 5 5 5 0 5 5 5 5 5 5 5 0 5 0 0 0 0 0 5 5 5 5 5 5 5 5 5 5 5 5 5 5 5 5 5 5 5 5 5 5 5 5 5 5 5 5 0 0 0 5 5 5 5 5 5 5 5 0 0 0 5 5 5 5 5 5 5 5 0 0 0 5 5 5 5 0 0 5 5 5 5 5 0 0 0 1 5 5 5 5 5 5 5 0 5 5 5 5 
5 5 5 5 5 5 5 5 5 5 5 5 5 0 0 0 0 0 0 0 0 0 0 5 5 5 5 5 5 5 5 5 5 5 5 5 1 1 1 1 1 1 1 5 5 5 5 5 0 0 0 5 5 5 5 5 5 5 5 0 0 0 5 5 5 5 5 5 5 5 5 5 0 0 5 5 0 0 5 5 5 5 5 5 5 0 0 1 5 5 5 5 5 5 0 5 5 5 5 5 
5 5 5 5 5 5 5 5 5 5 5 5 5 0 0 5 5 5 0 0 0 0 0 0 5 5 5 5 5 5 5 5 5 5 5 1 17 17 17 17 17 17 17 1 5 5 5 5 0 0 0 5 5 5 5 5 5 5 5 0 0 0 5 5 5 5 5 5 5 5 5 5 5 0 0 5 0 5 5 5 5 5 5 5 5 0 0 1 5 5 5 5 5 0 5 5 5 5 5 5 
5 5 5 5 5 5 5 5 5 5 5 5 5 5 5 5 0 5 5 0 0 0 0 5 5 5 5 5 5 5 5 5 5 5 5 1 17 17 17 17 17 17 17 1 5 5 5 5 0 0 0 5 5 5 5 5 5 5 5 5 0 0 5 5 5 5 5 5 5 5 5 5 5 5 0 0 0 5 5 5 5 5 5 5 5 0 0 1 5 5 5 5 5 0 5 5 5 5 5 5 
5 5 5 5 5 5 5 0 5 5 5 5 5 5 5 5 5 5 5 0 0 5 5 5 5 5 5 5 5 5 5 5 5 5 5 1 17 17 17 17 17 17 17 1 5 5 5 5 0 0 0 5 5 5 5 5 5 5 5 5 0 0 5 5 5 5 5 5 5 5 5 5 5 5 0 0 5 5 5 5 5 5 5 5 5 0 0 1 5 5 5 5 5 0 5 5 5 5 5 5 
5 5 5 5 5 5 0 5 5 5 5 5 5 5 5 5 5 5 5 0 0 5 0 5 5 5 5 5 5 5 5 5 5 5 5 1 17 17 17 17 17 17 17 1 5 5 5 5 0 0 0 5 5 5 5 5 5 5 5 5 0 0 5 5 5 5 5 5 5 5 5 5 5 5 0 0 5 5 5 5 5 5 5 5 5 0 0 1 5 5 5 5 5 0 5 5 5 5 5 5 
5 5 5 5 5 5 0 5 5 5 5 5 1 5 5 5 5 5 5 0 0 5 5 5 5 5 5 5 5 5 5 5 5 5 5 5 1 1 17 17 17 1 1 5 5 5 5 0 0 0 0 5 5 5 5 5 5 5 5 5 0 0 5 5 5 5 5 5 5 5 5 5 5 5 0 0 5 5 5 5 5 5 5 5 0 0 0 1 5 5 5 5 5 5 5 5 5 5 5 5 
5 5 5 5 5 5 0 5 5 5 5 5 1 5 5 5 5 5 0 0 0 5 5 5 5 5 5 5 5 5 5 5 5 5 5 5 5 5 4 4 4 5 5 5 5 5 5 0 0 0 0 5 5 5 5 5 5 5 5 5 0 0 5 5 5 5 5 5 5 5 5 5 5 5 0 0 5 5 5 5 5 5 5 5 0 0 0 1 5 5 5 5 5 5 5 5 5 5 5 5 
5 5 5 5 5 0 0 5 5 5 5 5 1 5 5 5 5 5 0 0 0 5 5 5 5 5 5 5 5 5 5 5 5 5 5 5 5 5 0 0 0 0 0 0 0 0 0 0 0 0 0 0 5 5 5 5 5 5 5 5 0 0 0 0 5 5 5 5 5 5 5 0 0 0 0 0 5 5 5 5 5 5 5 5 0 0 0 1 5 5 5 5 5 0 5 5 5 5 5 5 
5 5 5 5 5 0 5 5 5 5 5 5 1 5 5 5 5 5 0 0 0 0 5 5 5 5 5 5 5 5 5 5 5 5 5 5 5 5 0 0 0 0 0 0 0 0 0 0 0 0 0 0 0 5 5 5 5 5 0 0 0 0 0 0 0 0 0 0 0 0 0 0 0 0 0 0 5 5 5 5 5 5 5 5 0 0 0 1 5 5 5 5 5 0 0 5 5 5 5 5 
5 5 5 5 5 0 0 5 5 5 5 5 1 5 5 5 5 5 0 0 0 5 5 5 5 5 5 5 5 5 5 5 5 5 5 5 5 5 0 0 0 0 0 0 0 0 0 0 0 0 0 0 0 0 0 5 5 5 5 5 0 0 0 0 0 0 0 0 0 0 0 0 0 0 0 0 0 5 5 5 5 5 5 5 0 0 0 1 5 5 5 5 5 5 0 5 5 5 5 5 
5 5 5 5 5 5 0 5 5 5 5 5 1 5 5 5 5 0 0 5 5 5 5 5 5 5 5 5 5 5 5 5 5 5 5 5 5 5 0 0 0 5 5 5 5 5 5 5 5 0 0 0 0 0 0 0 0 0 0 0 0 0 0 0 0 0 0 0 0 0 0 0 0 0 0 0 0 0 5 5 5 5 5 0 0 0 0 1 5 5 5 5 5 5 0 0 5 5 5 5 
5 5 5 5 5 5 0 5 5 5 5 5 1 0 0 0 0 0 5 5 5 5 5 5 5 5 5 5 5 5 5 5 5 5 5 5 5 5 0 0 0 5 5 5 5 5 5 5 5 5 5 5 0 0 0 0 0 0 0 0 0 0 0 0 0 0 0 0 0 0 0 0 0 0 0 0 0 0 0 0 0 0 0 0 0 0 0 1 5 5 5 5 5 5 5 0 5 5 5 5 
5 5 5 5 5 5 0 0 5 5 5 5 1 0 0 0 0 5 5 5 5 5 5 5 5 5 5 5 5 5 5 5 5 5 5 5 5 5 0 0 0 5 5 5 5 5 5 5 5 5 5 5 5 0 0 0 0 0 0 0 0 0 0 0 0 0 5 0 0 0 0 0 0 0 0 0 0 0 0 5 5 0 0 0 0 0 0 1 5 5 5 5 5 5 5 0 5 5 5 5 
5 5 5 5 5 5 5 0 0 5 5 5 1 0 0 0 0 5 5 5 5 5 5 5 5 5 5 5 5 5 5 5 5 5 5 5 5 5 0 0 0 5 5 0 0 11 5 5 5 5 5 5 5 5 0 5 5 5 5 0 0 0 0 0 0 0 5 5 5 0 0 0 0 0 0 0 0 0 0 5 5 5 0 0 0 0 0 1 5 5 5 5 5 5 5 0 0 5 5 5 
5 5 5 5 5 5 5 5 0 0 5 5 1 0 0 0 0 5 5 5 5 5 5 5 5 5 5 5 5 5 5 5 5 5 5 5 5 5 0 0 0 5 5 0 11 0 5 5 5 5 5 5 5 5 5 5 5 5 5 0 0 0 5 5 5 5 5 5 5 5 5 0 0 0 0 0 0 0 5 5 5 5 0 0 0 0 0 1 5 5 5 5 5 5 5 5 0 5 5 5 
5 5 5 5 5 5 5 5 5 0 5 5 1 0 0 0 0 5 5 5 5 5 5 5 5 5 5 5 5 5 5 5 5 5 5 5 5 0 0 0 0 0 5 0 0 0 5 5 5 5 5 5 5 5 5 5 5 5 5 0 0 0 5 5 5 5 5 5 5 5 5 0 0 0 0 0 0 5 5 5 5 5 5 0 0 0 0 1 5 5 5 5 5 5 5 0 0 5 5 5 
5 5 5 5 5 5 5 5 5 0 0 5 1 0 0 0 0 5 5 5 5 5 5 5 5 5 5 5 5 5 5 5 5 5 5 5 5 0 0 0 0 0 5 0 4 0 5 5 5 5 5 5 5 5 5 5 5 5 0 0 0 0 5 5 5 5 5 5 5 5 5 5 0 0 0 0 0 5 5 5 5 5 5 5 5 0 0 1 5 5 5 5 5 5 0 0 5 5 5 5 
5 5 5 5 5 5 5 5 5 5 0 5 5 0 0 0 5 5 5 5 5 5 5 5 5 5 5 5 5 5 5 5 5 5 5 5 5 0 0 0 0 0 5 0 0 4 5 5 5 5 5 5 5 5 5 5 5 5 5 0 0 0 5 5 5 5 5 5 5 5 5 5 0 0 0 0 5 5 5 5 5 5 5 5 5 0 0 1 5 5 5 5 5 0 0 5 5 5 5 5 
5 5 5 5 5 5 5 5 5 0 0 5 5 0 0 0 5 5 5 5 5 5 5 5 5 5 5 5 5 0 0 0 0 0 0 0 0 0 0 0 0 0 5 0 0 5 5 5 5 5 5 5 5 5 5 5 5 5 5 0 0 0 5 5 5 5 5 5 5 5 5 5 0 0 0 0 5 5 5 5 5 5 5 5 5 0 0 1 5 5 5 5 5 0 5 5 5 5 5 5 
5 5 5 5 5 5 5 5 5 0 5 5 5 0 0 0 5 5 5 5 5 5 5 5 5 5 5 5 5 0 0 0 0 0 0 0 0 0 0 0 0 0 5 0 0 5 5 5 5 5 5 5 5 5 5 5 5 5 5 0 0 0 5 5 5 5 5 5 5 5 5 5 0 0 0 5 5 5 5 5 5 5 5 5 5 0 0 1 5 5 5 5 5 0 5 5 5 5 5 5 
5 5 5 5 5 5 5 5 0 0 5 5 5 0 0 0 0 0 0 0 0 0 0 0 0 0 0 0 0 0 0 0 0 0 0 0 0 0 0 0 0 0 5 0 0 5 5 5 5 5 5 5 5 5 5 5 5 5 5 0 0 0 5 5 5 5 5 5 5 5 5 5 0 0 0 5 5 5 5 5 5 5 5 5 5 0 0 1 5 5 5 5 5 0 5 5 5 5 5 5 
5 5 5 5 5 5 5 0 0 5 5 5 5 0 5 5 0 0 0 0 0 0 0 0 0 0 0 0 0 0 0 0 5 5 5 5 0 0 0 0 0 0 5 0 0 5 5 5 5 5 5 5 5 5 5 5 5 5 5 0 0 0 5 5 5 5 5 5 5 5 5 5 0 0 0 5 5 5 5 5 5 5 5 5 5 0 0 1 5 5 5 5 5 0 5 5 5 5 5 5 
5 5 5 5 5 5 5 0 5 5 5 5 5 5 5 5 5 5 5 0 0 0 0 0 0 0 0 0 0 0 5 5 5 5 5 5 5 0 0 0 0 0 5 0 0 5 5 5 5 5 5 5 5 5 5 5 5 5 5 5 0 0 5 5 5 5 5 5 5 5 5 5 0 0 0 5 5 5 5 5 5 5 5 5 5 0 0 1 5 5 5 5 5 0 5 5 5 5 5 5 
5 5 5 5 5 5 0 0 5 5 5 5 5 5 5 5 5 5 5 0 0 0 0 0 0 5 5 5 0 5 5 5 5 5 5 5 5 0 0 0 0 0 5 0 0 5 5 5 5 5 5 5 5 5 5 5 5 5 5 5 0 0 5 5 5 5 5 5 5 5 5 0 0 0 5 5 5 5 5 5 5 5 5 5 5 0 0 1 5 5 5 5 5 0 5 5 5 5 5 5 
5 5 5 5 5 5 0 0 5 5 5 5 5 5 5 5 5 5 5 0 0 0 5 5 5 5 5 5 5 5 5 5 5 5 5 5 5 0 0 0 0 0 5 0 0 0 5 5 5 5 5 5 5 5 5 5 5 5 5 5 0 0 5 5 5 5 5 5 5 5 5 0 0 0 5 5 5 5 5 5 5 5 5 5 5 0 0 1 5 5 5 5 5 5 0 5 5 5 5 5 
5 5 5 5 5 5 5 0 0 5 5 5 5 5 5 5 5 5 5 5 5 5 5 5 5 5 5 5 5 5 5 5 5 5 5 5 5 0 0 0 0 0 5 0 0 0 0 0 0 0 0 0 0 0 0 0 0 0 0 0 0 0 0 0 0 0 0 0 0 0 0 0 0 0 0 0 0 0 0 0 0 0 0 0 0 0 0 1 5 5 5 5 5 5 0 5 5 5 5 5 
5 5 5 5 5 5 5 5 0 0 0 0 5 5 5 5 5 5 5 5 5 5 5 5 5 5 5 5 5 5 5 5 5 5 5 5 5 0 0 16 0 0 5 0 0 0 0 0 0 0 0 0 0 0 0 0 0 0 0 0 0 0 0 0 0 0 0 0 0 0 0 0 0 0 0 0 0 0 0 0 0 0 0 0 0 0 0 1 5 5 5 5 5 5 5 5 5 5 5 5 
5 5 5 5 5 5 5 5 5 5 5 0 0 5 5 1 1 1 1 1 1 1 1 1 1 1 1 5 5 5 5 5 5 5 5 5 5 5 5 5 5 5 5 5 5 5 5 5 5 5 1 1 1 1 1 1 1 1 1 1 1 1 1 1 1 1 1 1 1 1 1 1 1 1 1 1 1 1 1 1 1 1 1 1 1 1 1 1 5 0 0 5 5 5 5 5 5 5 5 5 
5 5 5 5 5 5 5 5 0 0 0 0 5 5 5 5 5 5 5 5 5 5 5 5 5 5 5 5 5 5 5 5 5 5 5 5 5 5 5 5 5 5 5 5 5 5 5 5 5 5 1 1 1 1 1 1 1 1 1 1 1 1 1 0 0 0 0 0 0 0 0 0 0 0 0 0 0 0 0 0 0 0 0 0 0 0 0 0 0 0 5 5 5 5 5 5 5 5 5 5 
5 5 5 5 5 0 0 0 0 5 5 5 5 5 5 5 5 5 5 5 5 5 5 5 5 5 5 5 5 5 5 5 5 5 5 5 5 5 5 5 5 5 5 5 5 5 5 5 5 5 1 1 1 1 1 1 1 1 1 1 1 1 1 0 0 0 0 0 0 0 0 0 0 0 0 0 0 0 0 0 0 0 0 0 0 0 0 0 0 0 5 5 5 5 5 5 5 5 5 5 
5 5 5 5 5 0 0 0 0 5 5 5 5 5 5 0 0 0 0 0 0 0 5 5 5 5 5 5 5 5 5 5 5 5 5 5 5 5 5 5 5 5 5 5 5 5 5 5 5 5 5 5 5 5 5 5 5 5 5 5 5 5 1 1 1 1 1 1 1 1 1 1 1 1 1 1 1 1 1 1 1 1 1 1 1 1 0 0 0 5 5 5 5 5 5 5 5 5 5 5 
5 5 5 5 5 5 5 5 0 0 0 0 0 0 5 5 5 5 5 5 5 0 0 5 5 5 0 0 5 5 5 5 5 5 5 5 5 5 5 5 5 5 5 5 5 5 5 5 5 5 5 5 5 5 5 5 5 5 5 5 5 5 5 5 5 5 5 5 5 5 5 5 5 5 5 5 5 5 5 5 5 5 5 5 5 5 5 5 5 5 5 5 5 5 5 5 5 5 5 5 
5 5 5 5 5 5 5 5 5 5 5 5 5 0 5 5 5 5 5 5 5 5 0 0 0 0 5 0 0 0 0 0 0 0 0 0 0 0 0 0 0 0 5 5 5 5 0 0 0 0 0 0 0 0 0 5 5 5 5 5 5 5 5 5 5 5 5 5 5 5 5 5 5 5 5 5 5 5 5 5 5 5 5 5 5 5 5 5 5 5 5 5 5 5 5 5 5 5 5 5 
5 5 5 5 5 5 5 5 5 5 5 5 5 5 5 5 5 5 5 5 5 5 5 5 5 5 5 5 5 5 5 5 5 5 5 5 5 5 5 5 5 0 0 0 0 0 0 5 5 5 5 5 5 5 0 0 5 5 5 5 5 5 5 5 5 5 5 5 5 5 5 5 5 5 5 5 5 5 5 5 5 5 5 5 5 5 5 5 5 5 5 5 5 5 5 5 5 5 5 5
